tested word	predicted word
if	he
then	them
no	on
me	of
these	there
er	dr
no	on
erm	fro
us	up
go	in
mr	or
night	might
mm	on
home	good
war	was
go	in
am	an
saw	say
gave	have
line	kind
view	they
care	case
food	done
gone	good
home	good
b	a
uk	tl
cos	cop
us	up
soon	room
award	aware
game	hand
c	a
pay	say
round	sound
boy	any
fine	find
red	see
pounds	sounds
sun	run
round	sound
wide	wife
season	reason
paid	said
page	said
goods	homes
blood	alone
ah	ai
york	work
purpose	suppose
lack	jack
seem	seen
hot	got
past	part
post	sort
male	make
base	case
box	any
past	part
mum	nun
p	s
aid	age
seem	seen
stone	stood
mhm	mgm
bar	car
ball	call
gas	has
gold	hold
ec	da
e	d
band	came
no	on
offer	needs
past	part
sight	right
win	who
tree	used
games	hands
pound	sound
shape	share
wine	wind
user	uses
lay	law
rain	pain
sold	role
offer	needs
note	move
sites	river
join	john
card	case
cut	but
cell	bell
ian	ibm
r	s
bus	cup
corp	boss
tom	too
crown	brown
v	t
aim	ago
lose	lord
kinds	lines
phase	share
brief	cried
ooh	moi
paying	saying
save	rate
grey	grew
o	m
mine	mind
pay	say
un	to
hole	hold
h	i
inner	homes
add	bed
anne	come
tall	talk
odd	off
offices	officer
afford	before
bbc	cab
n	m
harry	happy
sick	pick
fast	east
meal	neck
walk	wall
n	m
net	met
committed	committee
sum	run
g	i
roof	some
cut	but
nose	more
lies	kids
co	an
ice	had
runs	stop
ref	see
rail	sail
noted	moved
autumn	button
f	d
cat	act
cards	cases
add	bed
loan	joan
th	uh
walk	wall
tired	three
jane	land
cut	but
cope	core
pub	rub
chain	again
lee	led
notion	motion
paid	said
dear	fear
ages	aids
care	case
images	inches
pay	say
dear	fear
wet	yet
round	sound
aside	cried
scope	score
sons	poor
gate	have
golf	hold
gap	has
die	did
rome	some
abuse	cause
pure	sure
dna	doc
offer	needs
v	t
pale	sale
stones	summer
coat	boat
mill	milk
fight	eight
cycle	awake
mood	none
employee	employed
mile	mike
fast	east
bid	age
proud	prove
ken	leo
sake	sale
pace	race
sheep	sides
chances	chamber
cool	book
l	k
note	move
y	x
port	sort
sand	same
defeat	effect
fees	deep
fee	fed
ends	does
fight	eight
wear	year
poll	roll
cut	but
remote	remove
kong	long
mp	or
sam	ran
wore	word
peak	real
rent	sent
ear	far
clock	block
andy	body
cake	able
aged	aide
round	sound
holes	holds
waves	water
deaf	dead
fat	eat
keith	leith
selected	rejected
dave	date
writes	writer
aha	cia
cattle	battle
purely	surely
zone	wood
san	ran
rang	sang
produces	producer
nhs	mir
net	met
ban	can
sold	role
raw	say
bone	come
me	of
joy	low
lake	jake
bars	cars
anna	bomb
pipe	rise
lane	land
rid	she
charter	chapter
bones	comes
adds	beer
keys	jews
sole	role
win	who
males	makes
tool	took
j	k
posts	sorts
lane	land
red	see
cotton	bottom
male	make
walk	wall
bare	case
fate	date
wire	wise
poet	soft
routes	potter
beds	beer
save	rate
noted	moved
fred	free
cm	an
tale	take
u	t
go	in
lands	james
past	part
bulk	bull
sheer	sides
davies	father
picking	shaking
kate	late
refer	seeds
win	who
lords	loses
moves	notes
tin	tim
bonds	comes
shapes	shares
marx	mary
asian	brian
cap	car
barry	carry
c	a
raf	sad
ward	yard
tonnes	toomer
rape	rare
resort	report
no	on
hate	have
eg	eh
alex	blew
concert	concept
purchaser	purchases
gear	hear
ray	say
tie	the
earl	dark
fat	eat
refer	seeds
stick	quick
arises	crises
roy	row
kit	lit
die	did
mm	on
easter	faster
pat	sat
bye	aye
tide	tied
pit	sit
pond	some
damp	fans
bond	come
q	s
dull	full
lose	lord
lover	loves
ride	side
note	move
neat	meat
fig	egg
liver	lives
w	x
maps	mass
mine	mind
plc	pla
surrey	sussex
no	on
dose	ford
hiv	hit
moves	notes
dec	fda
acres	cases
lake	jake
pc	pa
crops	cross
barrier	carries
cats	acts
kid	lie
lay	law
bases	cases
ph	si
prey	prew
lords	loses
loud	love
mild	mike
dc	da
dish	fish
rope	rose
mature	nature
chap	bias
balls	calls
crop	arms
join	john
mick	nick
cook	book
ends	does
inn	gon
sums	stop
ie	he
leaf	lead
dear	fear
ye	we
pays	says
j	k
fa	da
gang	hang
mobility	nobility
fan	dan
barriers	carriers
jordan	korean
urged	tried
ward	yard
selected	rejected
sequences	september
mines	minds
earn	farm
rejection	selection
boot	cont
km	jo
jan	jam
stick	quick
care	case
deck	deal
kiss	lips
mps	mrs
trick	trial
bonus	boots
nt	mt
shelf	rifle
wear	year
ici	hag
w	x
aged	aide
supplier	supplies
server	serves
cow	any
pole	role
striker	strikes
kim	jim
jet	let
pope	rose
runs	stop
ron	son
lorry	korry
pet	set
drank	frank
yep	yes
raid	said
sing	ring
ms	or
beans	adams
receives	receiver
gods	goes
pubs	star
woke	wolf
rally	sally
carrier	carries
sacred	scared
privatisation	ppgtatgpatgmm
sara	papa
br	as
suite	quite
poles	roles
blues	alter
tales	takes
scots	pants
bold	cold
lies	kids
r	s
then	them
rush	push
basin	cargo
seasons	reasons
carers	caress
cows	boys
pan	ran
intel	hotel
pint	shot
walks	walls
bile	bike
rounds	sounds
corn	born
ride	side
eec	fda
trades	trader
shelves	shelter
mps	mrs
duck	fuck
earning	farming
slim	skin
pipes	rises
dual	fuck
pigs	ship
zones	woods
ft	du
rage	said
lay	law
ace	bad
truck	usual
max	may
dare	ease
ml	ok
pie	she
lump	jump
clue	blue
z	x
comprising	conspiring
fond	done
imf	god
ed	de
ports	sorts
wines	winds
pm	so
polls	rolls
yo	wo
view	they
bosnia	cosmic
cd	be
jaw	law
am	an
gaps	harp
shy	six
movies	mother
shah	rich
invention	intention
centred	bemused
clive	alive
mask	mark
anc	bob
bride	cried
lid	lie
mice	nice
beam	adam
graph	iraqi
rat	sat
p	s
pump	stop
sank	rank
sink	pink
biscuits	circuits
grim	grin
acids	cages
hip	his
stick	quick
phases	shares
hp	is
reject	select
worlds	worker
bond	come
gall	hall
maker	makes
cage	acid
loudly	lovely
booked	cooked
lanes	james
seal	real
noting	moving
emailinc	dmagjgma
pots	soup
ego	dim
pine	shoe
lecturer	lectures
maths	mavis
bells	cells
rating	saving
bow	any
peaks	seals
eve	due
cakes	baker
socks	rocks
spine	prime
gp	is
shed	side
gdp	her
aloud	cloud
dairy	daisy
notions	motions
revised	retired
pits	sits
rna	rob
von	too
o	m
ram	ran
jay	law
sodium	podium
bp	as
eva	etc
non	mom
deer	deep
convert	contest
resting	serving
lay	law
rider	sides
paid	said
riot	shot
ad	be
dating	eating
trustee	trusted
phoned	pinned
peat	seat
verb	vera
fax	day
fist	dirt
rory	rosy
bass	cars
treasurer	treasures
hi	ii
ageing	aiding
cheques	chester
itv	hut
ruler	rules
g	i
sorted	posted
motif	movie
clues	alter
yarn	warm
riots	shots
slave	plate
relied	relief
defects	effects
cart	cast
dos	for
ringing	singing
di	eh
pope	rose
pin	sin
signing	shining
scotvec	pamttda
ad	be
altar	clubs
loch	koch
speeds	prefer
coache	bobbie

Tested: 8447
Wrong: 614
Correct 7833
correct: 92.73114715283532 %